BBBBBBBBBBBBBBBBBBBvBBBBBBB
B                        BB
B                        BB
B                        BB
B         BBBBB          BB
B      BBBBBBBB
       BBBBBBBB
BB  B^BBBBBBBBB^B  BB    BB
BB  BBBBBBBBBBBBB  BB    BB
BBBBBBBBBBBBBBBBBBBBBBBBBBB
BBBBBBBBBBBBBBBBBBBBBBBBBBB
B
B
BBBBBBBBBBBBBBBBBBBBBBBBBBB
BBBBBBBBBBBBBBBBBBBBBBBBBBB