BBBBBBBBBBBBBBBBBBBBBBBBBBBBB
B________________________BBBB
B________________________BBBB
B________________________BBBB
B>________^BBMB>_________BBBB
_______B^BBBBBB____________BB
_______BBBBBBBB____________BB
BBLLB^BBBBBBBBBB^LL^BLLLBBBBB
BBllBBBBBBBBBBBBBllBBlllBBBBB
BBBBBBBBBBBBBBBBBBBBBBBBBBBBB
BBBBBBBBBBBBBBBBBBBBBBBBBBBBB
B________________________BBBB
B________________________BBBB
BBBBBBBBBBBBBBBBBBBBBBBBBBBBB
BBBBBBBBBBBBBBBBBBBBBBBBBBBBB