BBBBBBBBBBBBBBBBBBBvBBBBBBBBB
B________________________BBBB
B________________________BBBB
B________________________BBBB
B_________BB^BB__________BBBB
_______BBBBBBBB____________BB
_______BBBBBBBB____________BB
BBLLB^BBBBBBBBB^BLLBBLLLBBBBB
BBllBBBBBBBBBBBBBllBBlllBBBBB
BBBBBBBBBBBBBBBBBBBBBBBBBBBBB
BBBBBBBBBBBBBBBBBBBBBBBBBBBBB
B_________________________BBB
B________________________DBBB
BBBBBBBBBBBBBBBBBBBBBBBBBBBBB
BBBBBBBBBBBBBBBBBBBBBBBBBBBBB