BBBBBBBBBBBBBBBBBBBvBBBBBBB
B________________________BB
B________________________BB
B________________________BB
B_________BBBBB__________BB
_______BBBBBBBB____________
_______BBBBBBBB____________
BB__B^BBBBBBBBB^B__BB____BB
BB__BBBBBBBBBBBBB__BB____BB
BBBBBBBBBBBBBBBBBBBBBBBBBBB
BBBBBBBBBBBBBBBBBBBBBBBBBBB
B__________________________
B__________________________
BBBBBBBBBBBBBBBBBBBBBBBBBBB
BBBBBBBBBBBBBBBBBBBBBBBBBBB