BBBBBBBBBBBBBBBBBBBvBBBBBBBBB
B________________________BBBB
B________________________BBBB
B________________________BBBB
B_________BB^BB__________BBBB
_______BBBBBBBB____________BB
_______BBBBBBBB____________BB
BB__B^BBBBBBBBB^B__BB___BBBBB
BB__BBBBBBBBBBBBB__BB___BBBBB
BBBBBBBBBBBBBBBBBBBBBBBBBBBBB
BBBBBBBBBBBBBBBBBBBBBBBBBBBBB
B_________________________BBB
B________________________DBBB
BBBBBBBBBBBBBBBBBBBBBBBBBBBBB
BBBBBBBBBBBBBBBBBBBBBBBBBBBBB