BBBBBBBBBBBBBBBBBBBSBBBBBBB
B                        BB
B                        BB
B                        BB
B         BBBBB          BB
B      BBBBBBBB
       BBBBBBBB
BB  BSBBBBBBBBBSB  BB    BB
BB  BBBBBBBBBBBBB  BB    BB
BBBBBBBBBBBBBBBBBBBBBBBBBBB
BBBBBBBBBBBBBBBBBBBBBBBBBBB
B
B
BBBBBBBBBBBBBBBBBBBBBBBBBBB
BBBBBBBBBBBBBBBBBBBBBBBBBBB